1111111111111111111
1E00000000000000001
1C01110100100000101
100CC10110101010C01
1111110100100000101
1C00010010101010001
100001010010C000101
1000010110101010001
1P0C000100000000001
1111111111111111111
